3
3
3
7,8,1,8,6,1,3,5,
9,9,S,9,9,4,7,1,
4,8,7,9,6,0,S,8,
6,7,7,4,6,2,6,0,
2,X,1,S,6,3,9,0,
4,3,7,7,2,4,4,6,
6,7,S,6,6,1,1,X,
9,3,S,2,7,2,5,6,
